■和訳
'cause	[短] = because
'em	[短] = them
20-20 hidsight	あと知恵，あとから言えること
a joint performance	協演
A&R	制作部員
A&R Man	Artist and Repertoire Man の略，制作部員
a.k.a	also known asの略，〜としても知られる，またの名を，別名
abandon	捨てる，見捨てる，（身を）任せる
abuduct	拉致する，誘拐する
abundant	豊富な
aberration	脱線行為
ability	能力，力量，手腕，才能
able	有能な
about	およそ，ほぼ，約，〜のあたりに（を、の），〜について，〜に従事して
above	〜の上に
abroad	外国に，海外に
abyss	底無し地獄
academy	学校，学院，学士院，芸術院，the Academy = the Royal Academy:英国美術院，the French Academy:フランス学士院
accelerator	加速装置
accept	受け取る，引き受ける，認める，容認する
access	接近，入り口，面接
accessible	近付き易い，手に入れ易い
acclaime	歓呼する，喝采する
acclamation	歓呼，喝采
accompany	同行する，付添う，随行する，伴奏する
accomplish	完成する
accomplished	完成した，上品な，（技芸に）熟達した
accordance	一致，調和
according	〜に従って，〜に応じて
according to	〜によると
accumulate	蓄積する
accurate	正確な，厳密な
achieve	成し遂げる，（目的を）達する
achieved	成し遂げた
achievement	功績，成功，成就
acknowledge	承認する
across	〜を横切って，〜を越えて
act	行為，幕；the third act 第三幕，演じる，行う
act on	に従って行動する
acting	演出，実演，演技，所作
action	活動，行為，行動
active	活動的，活発な，能動的
activist	活動家
actually	現実の，実際の，現在の
adapt	適合させる，適用させる，脚色する
adapted	適した，改作した
add	加える
added	加線
addition	付加，添加，加算
additional	追加の
address	宛名を書く，宛名
addressee	名宛人，受信人
admit	認める
adopt	採用する
adopted	採用された
advance	前進する，前進，前払い
advanced	進歩した，高等の
advancement	進歩，前進，向上，昇給
adventure	冒険，冒険する
advertising	広告，広告の
affair	事務，業務
affect	影響する，作用する
affiliation	入会，加入，合併，提携
affiliations	入会，加入，合併，提携
affordable	供給できる
afraid	心配で
after	〜のあとに，〜の次に
after all	やはり
again	再び
age	年齢
aggressive	強引な，攻撃的な
agile	軽快な，機敏な
agree	同意する，承諾する
agreement	同意，承諾，協定，一致，和合
ahead	前へ，前もって，あらかじめ
aid	促進する，手助けをする
aiiight	= a-ight allrightの俗語表現alrightをさらに崩した言い方
aim to do	〜にする事を目標にする
ain't	[短] = am not, is not
air mail	航空便
aka	a.k.aと同じ，also known asの略，〜としても知られる，またの名を，別名
alarm	警戒させる，危険を知らせる
alias	別名，偽名，またの名は，通称は
alien	外国の
alike	同様に
alive	活き活きした
allegation	容疑
allocation	割り当て
allow	許す
alminum	[米] アルミニウム　[英] = aliminium
aliminium	[英] アルミニウム　[米] = alminum
almost	ほとんど，たいてい，おおかた
along	〜に沿って
along with	と共に
alongside	横に，並んで
already	すでに，もはや
also	また，もまた，なお
altered	修正した
alternate	交互の，互い違いの，代替
alternative	二者一択の
although	= though　〜だけど
always	常に，いつも，いつでも
amaricana	アメリカ誌，アメリカ風俗
amaze	驚かす，びっくりさせる
amazement	驚き
amazing	驚くべき
ambush	待伏せ
among	〜の中に
amongst	〜の中に；= among
amount	要するに〜になる，に等しい
amuse	楽しませる
ancient	古代の，太古の
and yet	それにもかかわらず
anger	怒らせる
angry	怒った
animated	生気ある，活気に満ちた
animated cartoon	漫画映画
animation	生気，活気，元気
another	他の
anthem	代表歌
anthology	文学・音楽・美術などの選集，作品集，名曲集
any	どんな
anyone	誰も
anything	なんでも
anyway	とにかく
apotheosis	神格化，理想的（な例），極地
apotheosises	神格化，理想的（な例），極地
appear	現れる
appears	現れる
apple	リンゴ
appliance	電気器具，電化製品
applicable	適用される
applicant	応募者
application	適用，応用，申込書
apply for	〜を申し込む
appreciate	感謝する，正しく認識する，鑑賞する
appreciation	感謝，認識，識別，理解，鑑賞
apprentice	年季奉公人，年季奉公にやる
approach	に接触する，に話を持ち掛ける
appropriate	適当な，適切な
approximately	ほぼ正しい，おおよその
arcade	屋根付き街路
arcane	難解な
archrival	好敵手
architect	建築家
architecture	建築，建築術，建築物
archive	公文書保存所，記録保管所，古文書，記録類
area	地域，地方
aritistic	芸術的
arm	腕
arms	武器，兵器
army	陸軍，軍隊
around	回りを，辺りに，ぐるりと，四方に，〜の周囲に
arrival	到着，到達
arrive	着く，到着する，達する，到達する
arrow	矢，矢印
article	箇条，条項，記事，品物
artist	芸術家
as well as	〜と同様に
aside	脇へ，横に，別に
ask	尋ねる，問う，聞く
assembly line	流れ作業
assemble	集める，組み立てる
assembly	会合，集会，議会，（機械部品の）組み立て
assembly plant	組み立て工場
asset	資産
associate	交際する，連合する，組み合せる，連想する
associated	連合した，合同の，組合の
association	交際，連想，連合，協会，組合
assume	想定する
assumption	想定，前提
athlete	運動選手，運動競技者
athletic	運動の
attach	結び付ける，取り付ける，附属させる
attack	攻撃
attempt	試みる，企てる，試み，企て
attention	注意
attract	惹きつける
attraction	魅力
Aug.	8月
August	8月
authentic	真正の
authenticity	真実性
author	著者，著作者，作家，創始者，立案者
authorization	公認，認可，認定
authorize	権限を与える
autocratic	独裁の，独善的な
autocratic governments	独裁政権
automatic	自動の，自動装置の，無意識の，機械的の
automatically	自動的に，無意識に
automation	自動機械，自動人形
available	利用できる，手近にある
avenge	報復する
avenue	並木道，大通り
average	平均
away	遠方に，離れて
back	裏，背面，奥
background	背景
backing	伴奏，後援，支持
backseat driver	差し出がましい人，お節介な人
backstreet	裏通り，貧民街
backstreets	裏通り，貧民街
bad father	父親失格
bad mother	母親失格
baffle	当惑させる
baggage	荷物
baggage claim	手荷物預かり所
balance	釣り合わせる
ball room	大広間
ban	禁止する
bank	銀行
base	土台．基礎，基盤
basement	地下室
basic	基本の，基礎の，根本の
batch	一組，一群
battle	戦闘
bay	湾
bear	辛抱する，耐える
beat	打つ，脈打つ
beautiful	美しい，心地良い，鮮やかに，素敵な
because	なぜなら
become	〜になる
bed-sitter	bed-sitting-room の略，寝室と居間が兼用の一間のアパート，ワンルーム・マンション
beep	ビープ音
before	〜の前に
befriend	味方となる，助ける
begin	始まる，始める
beginning	最初，初期
behind	〜の後ろに
being	存在，生存
believe	信じる，と思う
believe in	の存在を信じる，の価値を信じる
belong	属する
belonging	属する
below	〜の下に
benchmark	ベンチマーク
beside	〜のそばに
best	最上の
bet	賭ける，賭け事をする，掛け金
better	もっと良い
between	の間に
beyond	以外に
beware	気を付ける，用心する
bias	偏向，偏愛，執着
bill	請求書
bird	鳥
birthday	誕生日
birthmark	ほくろ，あざ
birthplace	誕生地，出生地，故郷
bit	小片，少量，少し，（大衆雑誌向けの）豆記事，ネタ，お話，話題，演出，仕掛け
blessing	幸運，天の恵み
blind	手探りで，闇雲に，しゃにむに，得体の知れない，一寸先の見えない
block party	野外集会
blood	血，血液，血統，血縁，家柄
blow	吹く
blueprint	図面
blur	曖昧，不明瞭
blush	赤面する
board	板，食卓
bold	大胆な
bonus	賞与金，割増金
book	予約する
boost	促進する，強化する
boot	長靴
both	両方の，双方の
bottom	底
bottom line	肝心なのは，結局
bounce	跳ねる
bow	お辞儀をする；弓：語源も発音も意味も違う
box	箱
branch	枝
brand-new	新品の，真新しい
breed	種類
bridge	橋
brief	短い，簡単な；to the brief to the brief 簡単に言えば
briefly	簡単に，手短に
brilliant	優秀な，目覚しい
bring	持って来る
brochure	小冊子
broken	破れた，壊れた
brought	持って来た
buffer	緩衝器
bug	虫
build	建てる
bulldog	猛者
bulletin	掲示
bump	ぶつかる
bundle	束，包み，束ねる，包む
burden	負担，重荷
breaucracy	官僚制，官僚主義
burn	燃やす，焼く
burn rubber	急発進させる，車を飛ばす
bus	乗り合い自動車
business	職業，商売
busk	（通行人を相手に）芸をする，どさ回りの芸をする，大道芸をする
busker	大道（旅）芸人，香具師
busking	大道芸，大道芸人
busy	忙しい，多忙な
but	しかし
button	ボタン
buy	買う
by chance	偶然
buying	購買
cabinet	飾り箪笥，飾り戸棚
cache	隠し場，貯蔵品，隠蔽蔵物
caddy	[俗]　キャディラックの略
calculate	計算する
calculating	計算用の
Cali	[俗]　カルフォルニアの略
can	できる
candidate	志願者
candidates	志願者
cannot	できない
cap	帽子
capabilities	（将来伸びる）素質
capability	能力，才能
capable	有能な
capacity	容積，容量
capital	資本
capitalism	資本主義
captivate	虜にする，うっとりさせる，魅惑する
captivated	虜にした，魅惑した
captivation	魅惑
capture	惹き付ける
card	入場券
cards	カルタ遊び，トランプ遊び
care	心配，苦労
care about	を気にする
careful	注意深い，用心深い
carry	運ぶ
carry out	実行する，遂行する
cartoon	漫画
case	場合，事情，立場，実情，真相
casino	カジノ
cast	投げる，配役する，配役
castle	城
catalog	[英] 目録　[米] = catalogue
catalogue	[米] 目録　[英] = catalog
catch	捕まえる，受け止める，理解する，（注意を）引く，追い付く
catch up with	〜に追い付く
categorize	分類する
catfish	鯰
cause	原因，根源，元
cavern	大洞穴(large cave)
cell	細胞，個室，巣穴，独房
center	中心，中央，真中
century	世紀，100年
certain	確かな，正確な，確実な
certainly	確かに，きっと
chain	鎖，連鎖
chair	椅子
chairman	議長
challenging	手強い，厳しい，難しい
chance	機会
change	変化，変更，変える，変更する，両替する，乗り換える
chapter	章
character	記号，文字，字体，特徴，特性，性質，性格，品性，人格，人物
charge	料金，費用，負担金，税金
chat	雑談，談笑する
check	[米] 検査，照合　[英] = cheque
check this out	[俗]　よく聞いてくれ：相手の注意を引く時によく使われる
checking account	当座預金
cheque	[英] 検査，照合　[米] = check
Chi-town	[俗]　シカゴの俗称
chief	長官，首長
childhood	幼時，幼年時代
children	子供
chill	寛ぐ
chip	木片，破片，かけら
choice	選択
Choir	教会の聖歌隊
choose	選ぶ
chronicle	年代記，記録
church	教会
circa	およそ，ほぼ，約；通例 c. と略し不明な年号などに付ける
circle	円
circumstances	事情
city	市，都会，都市
claim	要求する，請求する，主張する，要求，請求主張
class	社会階級，学級，組，授業，講習，等級，種類
classic	古典，古典的な
classify	分類する，類別する
clean	きれいな，清らかな，見事な
cleaner	綺麗好き
clear	澄んだ，晴れた，冴えた，取り除く，取り払う
clever	才気ある，機知のある，利口な，賢い
click	カチッと鳴る（鳴らす），カチッという音
climb	よじ登る
close	閉じる
co-	[接頭詞] 共同，共通，同等
code	法典，慣例，符号，暗号
coffin	棺
cold boot	= cold start 休止状態のコンピューターに電源を入れて、システムを起動すること
collaboration	協力，共同制作
collapse	崩壊，倒壊，壊滅，崩壊する，
collection	収集品，集めたもの
color	色
colored	色を付けた
coloring	色を付ける
colors	人柄，姿，国旗，軍旗
colour	<英> 色
column	縦欄
combat	戦闘
combination	結合，連合，団結，結社
combine	結合する，連合する，合同する
comfortable	気楽な，安楽な
coming	来るべき，到来
command	命令する，指揮する，率いる，命令，指揮
comment	注釈，評注
commercial	営利的な
commercially	商業上，通商上
commit	（罪、悪事を）行う，委託する
commitment	約束，公約，委任，委託
common	共通の
community	共同体，社会
companion	仲間，相手，話し相手，道連れ
company	会社
compare	比較する
comparison	比較，対照，類似
compass	磁石，羅針盤
compatibility	矛盾しないこと，両立できること
compatible	互換がある
competition	競争，試合
competitor	競争相手，競合他社
compilation	編集，編集物
compile	編む，編集する
compiler	編集者
complain	不平を言う，苦情を言う
complete	完全な
completely	完全に
completion	完成，成就
complex	複合の，複雑な
complicate	複雑にする
complicated	複雑になった
compliment	無料の
complimentary	誉め言葉，儀礼的な挨拶
compose	組み立てる
compress	圧縮する，圧搾する
comprised	含む，包含する
compromise	妥協，示談，折衷案
computer	計算機，電子計算機
concentrate	集中する，専心する
concentrate on	注意を集める
concept	概念
concept album	一貫した主題を持ったアルバム
concise	簡明な
conclude	結末を付ける
conclusion	結末，終結，落着
condescend	謙遜する
condition	状態，条件
conduct	行為，行動，行状，品行，導く，指揮する
cone	円錐形
conference	会議，相談
confession	告白，白状
confidence	信頼，信任，信用，秘密
configuration	形状，輪郭，外形，地形
confirmed	確認された，確定された
conflict	闘争，矛盾，衝突，争う，衝突する，矛盾する
conform	確認，確定
conform to	〜に従う
confuse	混同する，混乱させる
confused	乱雑な，当惑した
confusion	混同，乱雑，混乱，騒動
conglomerate	集塊状の，集塊
conglomeration	集塊
connect	結合する，つなぐ
connection	連絡，接続，連結，関連，関係，縁故，取引先
conquer	征服する
conqueror	征服者
conquest	征服
conscious	知っている，気付いている
conservative	保守的な，地味な
conservatory	温室
consider	よく考える，熟考する，熟慮する
consist	〜から成る
consistent	首尾一貫した
constant	一定の，不変の
constitution	組織
construct	建設する，組み立てたもの	
construction	皇族，建造，建設
construction crew	建設作業員
consult	意見を聞く，相談する，協議する
consumer	消費者
consumers	消費者
contact	接触，連絡，交際
contain	含む
contemporaries	同時代の人たち
contemporary	同時代の
Contemporary Art	現代美術
content	内容，中身
contention	論争，主張，論点，競争
contest	競技
contingency	緊急事態，偶発事故
contingent	不慮の，偶発的な
continually	絶えず，頻繁に
continue	続ける，延長する，継続する
continuous	絶え間ない
continuously	絶えず，絶え間ない
contract	契約
contrast	対照，対比，対照する，対比する
control	支配する，管理する，監督する，競争する，強制する，操縦する，調節する，対策
controller	支配者，監督官，制御装置
convenience	便利，便宜，好都合
convenient	便利な，好都合な
convention	慣例，因習，しきたり
conventional	慣例の，因習的な，月並みの
conversation	会話
convert	変換する
convince	確信させる，納得させる
coodinate	同等の，同格の，同等にする，釣り合わせる，調整する
coodination	同等にすること，釣合，調整
cool stuff	素晴らしいこと
cooler	冷却装置
copy	複写，模写
copywrite	版権，著作権
cord	網，紐，コード
corn	穀物
corner	かど，街角，隅
corporation	法人
correct	訂正する
correction	訂正
correctly	正しく
correspond	一致する，符号する，釣り合う
corresponding	相当する，対応する，符合する
cos	[俗] becauseの省略形
cost	費用
could've	[短] = could have
council	会議，評議会，協議会
count	数える
counter	売り台，計算機
countless	数え切れない，無数の
country	国，祖国
countryman	同胞，田舎者
couple	対，一組
courage	勇気
course	道筋，進路，推移，方針，課程，教科，講座
court	宮廷，中庭
cover	被う，包む
coward	臆病者
crack	ひび，割れ目，傷，欠点
craft	専門技術，職人芸
craftsman	職人，熟練工
crash	破滅，失墜，墜落，撃墜，大音響を立てて崩れる
crawl	のろのろ進む
create	創造する，創作する
creation	創造，創作
creatures	生き物，動物
crossbow	石弓
crossing	横切ること，横断
crowded	混雑した
crown	王冠，王位，帝位
crucial	重大な，きわめて重要な
cruel	残酷な，無慈悲な，無情な
cruelty	残酷，残忍，無慈悲
crutches	松葉杖
cry	叫ぶ，泣く
cultural	文化的
culture	耕作，栽培，教養，文化，文明
cure	治す，癒す，治療する
curiosity	好奇心
curious	奇妙な，奇態な，珍しい，好奇心に富んだ
curiously	奇妙に，奇態に，変に
current	流通する，流行する，目下の，現在の, 現行の
currently	現在は，目下，一般に，あまねく，流通して
custom	慣習，慣例，風習
customer	顧客，取引先
customs	関税，輸入税
cut	曲
cute	可愛らしい
cutting-edge	最先端の，最新鋭の
cuz	[俗]　becauseの省略形
cycle	周期，循環
daily	毎日
damage	損傷，損害，損傷する
damages	損害賠償
danger	危険，危険物
dangerous	危険な，危ない
dangle	ぶら下げる
dare	〜する勇気がある
dark	暗い，黒い，黒ずんだ，陰鬱な，暗黒，闇，夜
darkness	暗黒，闇
dash	突進する
data	根拠，材料，資料
date	年月日，日付
dawn	夜が明ける，夜明け
day	昼，昼間
dead	死んだ，枯れた，生命のない
deal	分配する
dear	愛する，親愛なる
death	死
deathwatch	死の番人
debuet	初舞台，初出演，初出場，初登場
Dec.	12月；Decemberの略
decade	10年間
deceive	欺く，騙す
December	12月
decent	見苦しくない，穏当な，慎みのある
decide	〜を決める，判決する，裁決る
decision	決定，断定
declaration	宣言，布告
declare	言明する，宣言する
decorate	飾る
decoration	飾り
decrease	減少する，減じる，減らす
dedicate	捧げる，献納する，奉納する
dedication	奉納，献納，献身
deed	行為，行動，実行
def	[俗]　格好いい
default	不履行，怠慢，違約
defend	守る，防衛する
define	定義する，明らかにする
definitely	決定的な，最終的な
degree	角度，学位
delete	削る，消す
delicate	微妙な
delight	喜ぶ，喜ばせる
delightful	大いに楽しい，実に喜ばしい
deliver	引き渡す，届ける，配達する
demand	要求する，要求
demonstration	示威行動
deny	断る，否定する，否認する
department	部，部門
depend	当てにする，次第である
dependant	〜による，次第である
dependent	〜による，次第である
deplete	使い果たす，枯渇させる
deposit	預金
describe	描写する
description	叙述，記述，描写
desert	砂漠，荒野
design	計画，設計図，図案，計画する，設計する，図案を書く
designate	指定する
designed	計画的の，設計した
designers	意匠設計家，図案家
desirable	望ましい，願わしい
desire	欲望，願望
despair	絶望，断念
despise	軽蔑する，蔑む
despite	〜にもかかわらず
destination	目的地，届け先
destroy	破壊する
destructive	破壊的な，有害な
detached	分離した，離れた
detail	細部
detailed	詳細な
detect	発見する
detective	探偵
determine	決定する
determined	決心した
develop	開発する，発見する，発達する，発達させる
development	発達，発展，開発
deviation	逸脱
device	装置，機器
devil	悪魔
devote	捧げる，専念する
dexterity	器用，機敏，利口
dial	文字盤，回転盤
dialog	対話，問答
dialogue	対話，問答
diamond	金剛石
diary	日記
dictation	口授，命令，書き取り
dictionary	辞書
die	死ぬ
diet	規定食，食事療法を行う
difference	違い，差異
different	違う，異なる，別の
difficult	困難な
difficulty	困難，苦労
dimension	次元
dimly	うす暗く，かすかに，ぼんやりと
ding	ジャン（鐘の音）
dip	ちょっと浸す
direct	指導する，指揮する，命令する，演出する，監督する
direction	方向，方角
directly	直に，直接に
directory	人名録
dis 'n' dat	[俗]　this and that　醜聞　
disable	働けなくなる
disappear	見えなくなる，焼失する，消滅する
disappoint	失望させる，落胆させる
disc	= disk  平円形盤，音盤
disclaim	権利を放棄する
discounts	割引
discover	発見する
discovery	発見
discribe	評する
discription	描写
discuss	討議する，議論する
discussion	議論，討論，討論
disguise	変装する，変装
disk	= disc 平円形盤，音盤
diskette	平円形盤
disorder	無秩序，混乱，騒動
disorganize	組織を破壊する
displace	置き換える，取って代わる
display	展示する，陳列する，陳列
dissimilar	異なる，似ていない
distance	距離
distant	遠い
distill	蒸留する
distinct	はっきりした
distinction	区別，差別，名声
distinctive	はっきりした差異のある，独特の
distribute	分配する，配布する，配給する
distribution	分配，配布，配給
distributor	配給者
divide	分ける
dividend	配当
document	文書，書類
documentation	仕様書
does	〜した
doing	すること，行動，活動
dollar	ドル
domain	領域
dome	丸屋根，丸天井
door	戸，戸口，玄関
doorway	戸口，入り口
double	二重の，二倍
doubt	疑う
down	下へ，下に
down to earth	気取りのない，自然体の，気さくな
download	（コンピュータ間でのデータの）移送，複写
downside	欠点
downtown	下町
dozens	ダース
draft	草案
drag	引きずる
dragon	竜
drama	戯曲，脚本，劇，演劇，芝居
dramatic	劇的な
draught	通風，すきま風
draw	引く，引っ張る
drawer	引出し
drawing	製図，図画
dreadful	恐ろしい，怖い
dream	夢
dress code	服装規定
drift	漂う
drill	練習
drive	運転する，操縦する
drive-by	車を走らせながら発砲すること
driver	運転手
driving	運転すること
due	当然の，正当な
dull	鈍い，遅鈍な，活気のない
dumb	口がきけない
dunno	[短] = don't know
dungeon	土牢
duplicate	二重の，複製の，複製，謄本，写本
during	を通じて
duty	義務
dying	死にかかっている
dynamic	動的な，力強い
dynamite	ダイナマイト
each	おのおのの，それぞれの
eager	熱心な
early	早く
earn	で稼ぐ，で儲ける，を得る
earnest	真面目な
earnings	稼ぎ高，所得，利益，儲け	
earth	地球
easily	容易に
east	東，東方，東部
eastern	東の，東方の
eastward	東側の
easy	容易な
eat	食べる
eclectic	取捨選択する
economic	経済の
economical	経済的な
economics	経済学
edge	刃
editor	編集者
editorial	社説の
educate	教育する
education	教育
educator	教育者
effect	効果，影響
efficiency	能力
effort	努力，力作，労作
efforts	努力，力作，労作
eg	たとえば
eight	8
eighteen	18
eighth	8番目
eighty	80
either	どちらか
eject	取り出す
elect	選ぶ
election	選挙
electonic	電子の
electonics	電子工学
electric	電気の
electricity	電気
elegant	上品な
element	要素
elementary	初歩の
elevator	エレベーター，昇降機
eleven	11
eliminate	削除する
elimination	削除，除去，排除
else	それ以外に
embarrased	困っている
embedded	はめ込む
emergency exit	非常口
empty	からの
emulate	競い合う，倣う
emulator	競争者
enable	可能にする
enclose	取り囲む
encompass	取り囲む，取り巻く，包み込む，包含する
encounter	遭遇する
encourage	奨励する
end	終わり
ending	最終
enemy	敵
engage	〜を雇う
engine	エンジン
engineer	技師
engineering	工学
enhance	高める，強める，増す
enhancement	高機能
enhances	強める
enjoy	楽しむ
enjoyable	楽しい
enjoyment	楽しみ
enough	十分な
enroll in	登録する
entering	はいる
entertain	楽しませる
entire	全体の
entirely	全く
entitled	権利を与える
entitles	権利を与える
entrance	入り口
entry	入る
environment	環境
episode	挿話
equal	等しい
equipment	装備
er	[英] はい　[米] = uh
era	時代
erase	消す
eraser	消しゴム
erect	直立した，直立させる
erroneous	誤った
error	間違い，誤り
escape	逃げる，脱出する
especially	特に
essential	本質の，本質的，要素，要点
essentially	本質的に，実質上
establish	確立する
establishment	施設
estimate	見積もる，評価する
even	等しい
evening	晩
event	出来事
eventual	結局の
eventuality	不慮の事件，万一の場合
eventually	結局，遂に
ever	かつて
every	すべての
everybody	誰も彼も
everyday	毎日
everyone	誰も彼も
everything	何もかも皆
everywhere	どこでも
evrey	すべての
exact	正確な
exactly	正確に
exam	試験
examination	試験
examine	試験する
example	例
excel	〜をしのぐ
excellent	優れている
except	除く
exception	例外
excerpts	抜粋
excess	行き過ぎた行為，超過
exchange	交換する
excite	興奮させる
excitement	興奮
exciting	興奮させる，はらはらさせる，手に汗を握るような
exclaim	大声で叫ぶ
excuse	許す
executable	実行可能な
execute	実行する
exercise	練習
exhibit	展示する
exhibition	展示会
exhibitions	表示
exist	存在する
existance	存在
exit	出口
exiting	退出する
expand	広げる，拡大する
expanded	拡張した
expect	予期する
expensive	高価な
experience	体験する
experiment	実験
expert	専門家
expertise	専門技術
explain	説明する
explanation	説明
explode	爆発する
exploration	探検
explore	探検する
explored	調査した
explorer	探検家
explosion	爆発
explosive	爆発性の
export	輸出
express	表現する
expression	表現
extend	伸ばす，延長する，広げる
extended	伸ばした，延長した，伸びた，長い，広い
extension	拡張，延長
extensive	広い
extensively	広範囲に渡って
extent	広さ，大きさ，範囲，程度
exterior	外部，外観，外面
external	外部の，外面の，外界の，外部，外面
externals	外観
externaly	外部に，外的に
extra	特別の，余分，随時の，号外，臨時雇い
extract	抜粋する，摘出する，抽出する，抜書き，抜粋，引用句
extraction	抽出，抜粋，引用
extraordinarily	並外れて，異常な
extraordinary	非凡な
extreme	極端な
extremely	極端に
faced	直面した
facilitating	容易にする
fact	事実
factor	要因
factory	工場
fail	失敗する
failure	失敗
fair	公正な
fairly	かなり
faithful	忠実な
fall	落ちる
familiar	親しい
family	家族
famous	有名な
fan	扇，団扇，贔屓
fantasy	空想，幻想
fantasy	幻想文学作品，時に空想科学小説
far	遠くに
fare	料金
farewell	別れ
farther	もっと先の
fast	速い
fasten	締める
faster	速さ
fastest	最も速い
fatal	運命の，宿命的な，命取りの，致命的な
fatalism	宿命論，宿命観
fatalist	宿命論者
fate	運命，天命
fated	運命によって定まっている，運命の尽きた
fateful	宿命的な
fatefully	宿命的に
fault	欠点
favor	好意
favorably	好意的に
favorite	お気に入りの
favour	好意
favourably	好意的に
favourite	大好きな
fear	恐れ
fear of height	高所恐怖症
featured	特徴を示す
features	特色
featuring	呼び物とする
Feb.	Februaryの略，2月
February	2月，Feb.は略
fee	料金
feel	触る
feeling	気持ち
feet	フィート
fellow	仲間
fetch	取って来る
feudal	封建制の
fever	熱狂
few	少しの
fiction	作り話
field	範囲
fiery	炎の，燃え盛る，火のような，熱烈な，
fifteen	15
fifth	5番目
fifty	50
fight	戦う
fighter	戦士
fighters	戦士
figure	図形
file	書類
fill	満たす
final	最後の
finally	最後に
find	見つける
fine	すばらしい
finish	終わり
firm	しっかりしている
firm	会社
firmly	しっかりと
first	一番目
fit	適当な
fitness	適切
five	5
fix	固定する
flag	旗
flash	ぱっと光る
flat	平らな
flavour	味，風味，趣き
flee	逃げる
fleeing	逃げる
flier	飛行士
flight	飛行
fling	投げる
float	浮く
floating	浮いている
floor	床
floors	床
floppy	フロッピー
flow	流れ
flower viewing	お花見
fly	飛ぶ
foe	敵
fog	霧
fold	〜を折り畳む
folk	人々
folks	人々
follow	の後に続く
following	次の
food	食料
force	影響力
forest	森林
forever	永遠に
forget	忘れる
forgetful	忘れっぽい
forgiveness	寛大さ
form	形
formal	形式的
format	初期化する
former	かっての，元の；former soldier 元兵士
forth	前へ
fortunate	幸運な
fortunately	幸運にも
fortune	運命
forty	40
forward	前方へ
found	探す
four	4
fourteen	14
frame	枠
free	自由
freedom	自由
freely	自由に
freeze	凍る
frequent	頻繁な
frequently	たびたび
fresh	新鮮な
friar	修道士
friday	金曜日
friendlier	より親切な
friendly	親切な
frighten	ぎょっとさせる
from	〜から
front	前
frontman	表看板，客引き，呼び込み，指揮者，総合司会者
fruit	成果
full	すべての
function	機能
functionality	機能
furnished	備えた
further	さらに
fuse	融合する，融合された
future	未来
gain	得る
gained	増えた
game	遊戯，勝負，競技，試合
games	遊戯，勝負，競技，試合
garage	車庫
garbled	ゆがんだ
gate	門
gather	集める
gathered	集める
gazette	新聞(官報)
general	一般的の
generally	一般に
generate	起こす
generate	生じる
generated	発生した
generator	発電機
generous	寛大な
get	得る
ghost	幽霊
giant	巨大な
gift	贈り物
gig	1回の出演，仕事，出演契約
give	与える
given	特定の
gives	与える
glad	うれしい
gladly	喜んで
glee	大喜び
go	行く
goin'	[短] going
gold	金
golden	金の
gonna	[短] = going to
good	良い
goodness	善良さ
goods	商品
goodwill	好意
gorgeous	豪華な
gossip	うわさ話
gotta	[短] = got to	
govern	統治する
governed	管理する
grab	掴まえる
grace	優美，上品，気品
gracefull	優美な，上品な，しとやかな
grade	等級
gradually	しだいに
graid	等級
grand	壮大な，雄大な，壮麗な，[米口語] 1000ドル
granted	許す
graph	図式，図表
graphical	絵のような
grateful	感謝している
gray	灰色
great	偉大な
greater	より大きいもの
greatly	非常に
greedy	欲の深い
greement	同意
green	緑色
greeting	挨拶
grey	灰色
grip	握り
ground	地面
grouping	組合せる
grow	成長する
grown	成長した
guard	〜の番をする
guess	〜を推測する
guess	推測する
guest	客
guide	手引き
guitarist	ギター奏者
gun	鉄砲
guttural	（声が）喉から出る
guttural voice	喉声で
habit	習慣
had	していた
half	半分
halfway	途中に
ham	酔っ払っている放浪者
hand	手
hand out	〜を配る
handful	ひとつかみ
handling	取扱い
hands	手
hang	掛ける
happen	起こる
happens	起こる
happily	幸福に
happiness	幸福
happy	幸福
harder	激しい
hardly	ほとんど
harry	急ぐ
hatch	卵を孵す
haunt	現れる
haunting	耐えず心に浮かぶ，忘れられない
have	持っている
having	所有
hazard	危険
hazardous	危険な
he	彼
head	頭
heading	見出し
headlong	まっさかさまに
heal	癒す
health	健康
healthy	健康な
hear	聞く
heavily	ひどく
heavy	重い
height	高さ
help	助け
helper	援助者
helpful	役に立つ
helping	手助けする
her	彼女の
here	ここに
herein	この中に
herself	彼女自身
hexadecimal	16進数
hidden	隠された
hide	隠す
high	高い
higher	より高い
highest	高い
highlight	最高潮の場面
highlighted	最も目立つ
highly	高く
higt	高い
him	彼を
himself	彼自身
hint	ヒント
hire	雇う
his	彼の
historical	歴史の，歴史上の，歴史的な
historical figure	歴史上の人物
hit	打つ，当てる，襲う
hobo	汽車にタダ乗りして、あちこち放浪する生活
hold	抱える，握る，保つ，拘留する，保留する，所有する，保持する，持続する，適用される
homage	尊敬
homemade	自家製の，手製の
hometown	郷里の町
homework	宿題，内職
honest	正直な
honesty	正直
honor	名誉，名声，敬意
honour	名誉
hop	跳ぶ
horizon	地平線
horizontal	水平の
host	主人，主催者，当番
hot	熱い
hour	時間
hourglass	砂時計
hours	時間
house	家
housed	家
how	どんなふうに
however	たとえ〜でも
huge	巨大な
human	人間の
human beings	人間
humble	慎ましい
humid	湿気の多い，湿っぽい
humidity	湿度
hundred	100
hurdle	障害物
hurry	急ぐ
I realized	よく分かるよ
I'd	[短] = I would, I had
icon	像，偶像
idea	考え
ideal	理想
identical	同一の
ie	すなわち
if	もし
ignore	無視する，省みない
ill	悪い
illegal	不法の，違法の
illness	病気
image	像，心象
imaginable	想像できる
imagination	想像
imagine	想像する
imitate	〜を模倣する
imitation	まね
immediate	即座の
immediately	直ちに
immense	広大な，巨大な，無限の
immigration	入国管理，移住
impatient	我慢できない
implement	実行する
implore	哀願する
importance	重要さ
important	重要な
impossible	不可能な
impress	印象づける
impression	印象
improve	改善する
improvise	即興で演奏する，即興で作る
in a line	列になって
in case	〜する場合に備えて
in term of	〜の観点から，〜に関して言えば
in the future	今後は，これからは
in the long run	長い目で見れば，長期的には
incapable	無能な
incarnation	具体化，化身
inch	インチ
inclined	傾ける
include	含む，入れる；[反]exclude
incomparable	比較できない
incorrect	誤った
increase	増加する
increased	増加した
increases	増える
increasingly	ますます
incredibility	信じられないこと，信用できないこと
incredible	信じられない，信用できない，途方もない
incredibly	信じられないくらい
indeed	ほんとうに
indelible	消すことの出来ない，忘れることの出来ない
independence	独立
independent	独立の
independently	独立して
index	索引
indicate	示す
indicated	表示する
individual	個人
industry	産業
industry standards	業界標準
inevitable	避けられない，のっぴきならない，必然的の
inflict	(苦痛を)与える
influence	影響
inform	知らせる
informal	形式ばっていない
information	情報
informed	知識のある
initial	最初の
initialization	初期化する
inner	内側
inprove	改善する
input	入力
insert	挿入
inside	内側
inspiration	霊感
install	導入
installation	据え付け
installed	導入した
instance	実例
instead	その代わりに
instinct	本能
instruction	命令
insure	保証する
intellectual	知的な
intelligence	知力
intelligent	知的な
intend	〜するつもり
intentionally	故意に
intently	熱心に
interest	興味
interested	興味を持った
interesting	興味深い
interface	接触面
internal	内部
international	国際的
interpreter	解説者，通訳
interrupt	割り込み
intervai	間隔
intervention	介入，干渉
inteview	取材，面談
into	の中へ
intricate	複雑な
introduce	紹介する
introduction	前書き
introductory	紹介の
invade	侵入する
invaluable	非常に貴重な
invent	発明する．でっち上げる
invention	発明，考案，新案
inventive	発明の才のある
inventor	発明者，発明家
inventory	目録，在庫品，棚卸し，目録を作る，棚卸しをする
investigation	捜査
invitation	招待
invoke	呼び出す
involving	伴う
issue	発行
issue	論点，問題
item	項目
its	それの
itself	それ自身
Jan.	Januaryの略，1月
January	1月，Jan.は略
Jersey	ジャージー島；イギリス海峡にある Channel Islands 中の最大の島
jewelry	[米] 宝石，貴金属　[英] = jewellery
jewellery	[英] 宝石，貴金属　[米] = jewelry
job	仕事
join	結合する
joke	冗談
journeyman	年季奉公が終わり一人前になった職人
joyful	うれしい
judgment	[米] 判決，審判，裁判　[英] = judgement
judgement	[英] 判決，審判，裁判　[米] = judgeement
Jul.	7月
July	7月
jump	飛ぶ，跳ねる
jumped-up	にわか作りの
jumping	跳躍
Jun.	6月
June	6月
jungle	そう林，密林
just	ちょうど
justice	正義
keen	鋭い，鋭敏な
keep	保つ
keeper	番人，管理人
keeping	維持，保存，保管
kernel	核
key	鍵
keyboard	鍵盤，鍵盤楽器
kill time	時間をつぶす
kind	親切
kinda	[短] = knd of
kindly	親切に
kindness	親切
kit	道具箱
kneel	ひざまずく
knife	小刀，包丁
knock	打つ，叩く，とんとん叩く
know	知る
knowledge	知識
known	知られている
laid-back	肩の力を抜いた，自然体の，悠々とした
lamp	灯り
land	陸
landfill	ゴミ焼却場
language	言語
large	大きい
larger	より大きい
last	終わり，最後の，とっておきの
late	おそい
lately	近ごろ
later	よりおそい
latest work	最新作
latter	後者の
laud	賛美する，賞賛する
lawyer	弁護士
lay	置く
layer	層
lead	中心の，主役の，導く
lead vocal	主旋律を歌う人で、主にロック・バンドの歌手について言う
leader	主導者
leader dots	前略や中略、後略などを示す符号「...」を言う，= three dots
leading	主要な
learn	学ぶ
learning	学習
least	最小
leave	残す
left	左
legal	法律上の
lend	貸す
length	長さ
less	より少ない
let	許す
letter	手紙
level	水準
liberty	自由
librarian	図書館職員
library	図書館
licence	[英] 許可，認可，免許，鑑札，免許証　[米] = licence
license	[米] 許可，認可，免許，鑑札，免許証　[英] = licence
licensed	許可した
life	生命
life-style	生き方，生活態度
lift	持ち上げる，上げる
light	光，灯火，火
lighter	点火器
lightly	軽く
lightning	稲妻，電光石火の
like	〜の様に
limit	限界
limitation	限界
limited	限られた，一応の，まずまずの
line	線，歌詞
link	連ける，連系，関連，連絡
list	表，一覧表
little	小さい
load	荷，積み荷，負担
loaded	荷を積んだ
local	generalの反対語で「全国の」に対して「ある特定の土地の」の意，日本語の「地方の」、「田舎の」の意ではない，その英語はprovincial, rural, regional を用いる
local	地方的
locate	位置を示す
location	位置，場所
lock	錠
log	丸太，航海日誌
logo	意匠文字
long	長い
look	見る
looked	見る
loop	輪
lose	失う
lost	失った
lot	たくさん
loud	大きい
loudly	大声で
low	低い
lower	降りる
loyal	忠実な
luck	運
lucky	幸運な
machine	機械
made	作った
magazine	雑誌
mage	魔法使い
magic	魔法
magnet	磁石
magnetic	磁石の
mail	郵便
mailbox	郵便ポスト
main	主要な
mainstream	主流，本流
maintain	維持する，持続する
maintenance	維持，持続
major	主要な，一流の
make	作る
maker	製作者
making	製造
manage	管理する，運営する，経営する
management	処理
manager	支配人，監督，やりくりをする人
managing	支配する，経営する
manner	方法
manual	便覧，入門書，案内書
manufacturer	制作，製造，製品
many	多くの
map	地図
mapper	作図者
mapping	作図
maps	地図
Mar.	3月
March	3月
mark	印
market	市場
mask	仮面
massive	大規模な，大々的な
master	主人，雇い主
mastermind	黒幕
masterpiece	傑作
mastery	支配
math	数学
mathematical	数学の
mathematics	数学
may	できる; May:5月
maybe	たぶん
mayor	市長
MC	master of ceremonies または microphone controller の略で、”司会者=マイクを持つ持つ者”から来ている俗語でラッパーを意味する
me	私に
mean	意味する
meaning	意味
means	方法，手段
measure	計量
measured	測った
meet	会う
meeting	集会
member	一員，成員，会員
memorial	記念の
memory	記憶
menu	献立表
merchandise	商品
merge	合併する，合流する
merger	合併
message	通信，言付け，伝言
messenger	配達人
meter	[米] メートル　[英] = metre
method	方法
metre	[英] メートル　[米] = meter
middie	中間
migrate	移動する，移住する
migth	能力
might've	[短] = might have
military	軍隊の
millimeter	ミリメートル
million	百万
mind	心
mine	私のもの
minimum	最低の
minor	より小さな
minute	分
miscast	不適任な役に当てる，下手な役を当てる
miss	失敗
missile	飛び道具，ミサイル
missing	欠けている
mistake	まちがい
mistaken	間違った
mix	混ぜる
mode	様式
model	模型，雛型
moderate	適度の
modern	近世の，現代の
Modern Art	近代美術
modified	修正した
moment	瞬間
monday	月曜日
money	お金
moniker	渾名，愛称	
monitor	忠告者，監視者
monster	怪物
month	月
moodily	不機嫌に，憂鬱に，むっつりと
more	より多く
most	最も多く
mostly	おもに，大部分が
mother	母
motherland	母国
motor	原動機
mouse	二十日鼠，パソコンの入力装置の一種
move	動く
movement	動作
movie	映画
Mr	さん，氏，様，君，先生; misterの略でSir, Lordなど他の敬称がない男性の姓名に冠する敬称，Mrとドットなしで記すのは最近の英国あるいはカナダ、オーストラリアで書かれた可能性が大きい
Mr.	さん，氏，様，君，先生; misterの略でSir, Lordなど他の敬称がない男性の姓名に冠する敬称，Mrとドットなしで記すのは最近の英国あるいはカナダ、オーストラリアで書かれた可能性が大きい
much	多くの
multiple	複合の
music	音楽
musicianship	音楽家としての才能
must	〜しなければならない
mutter	つぶやく
muttering	つぶやく
my	私の
myself	私みずから
mysterious	不可解な
mystery	神秘
nail	爪
name	名前
nap	うたた寝
narrow	狭い
nation	国民
national	国民の
native	生まれた
natural	自然の
navigation	航行，航海
near	近くに
nearby	近くの
nearly	殆んど
neat	清潔な
necessary	必要な
neck	首
need	必要
needed	必要だ
negotiation	交渉
neighbor	隣人
neighborhood	近く
neither	どちらも〜でない
Netherlander	オランダ人
Netherlands	ネーデルランド：俗にオランダ( Holland )と言う
network	網，網目細工
never	決して〜でない
new	新しい
news	報道，新聞記事
next	次
nice	素敵な
night	夜
noble	高貴な
nobody	だれも〜でない
noise	騒音
nominal	わずかの
non	(否定)
none	何も〜ない
nor	また〜も〜ない
normal	標準
normally	標準どうりに
north	北
nose	鼻
notation	記数法
note	音符，覚書
notebook	筆記帳，雑記帳
nothing	何も〜ない
notice	予告
notified	通知する
Nov.	11
novelty	新案商品，目先の変わった商品
novelty goods	景品広告
novelty song	1920-30年代に流行した面白おかしい歌
November	11月
novice	初心者
now	今
number	数
numeric	数の
numerous	多数の，たくさんの
nurse	看護婦
nylon	ナイロン
Oaktown	[俗]　カルフォルニア州オークランドの俗称
oar	櫂，櫓
obey	〜に従う
object	対象物
objection	異議
objective	目的
observation	観察
observe	〜を観察する
obstacle	障害
obstacles	障害物
obtained	手に入れる
occur	起こる，生じる
ocean	大海
oclock	時間
Oct.	10月
October	10月
odd	奇数の
off	離れた
offensive	攻撃
offer	申込み
offered	提供した
offering	贈物
office	事務所
officer	将校
often	しばしば
often-read	たびたび読む
oil	油
Old School	[俗] 古い，古き良き時代の，昔のままの
old	古い
older	より古い
oldest	最も古い
omit	〜を抜かす
omitted	省略した
omnibus	同一の作家の既刊の作品を一冊にまとめたもの
omnibus book	個人の作品または同類の名作家の作品をまとめた廉価本
on earth	一体全体
once	一度
one	1
only	唯一の
onto	〜の上に，〜に向かって
open	開く
operate	操作
operating	操作する
operation	操作
opportunity	機会
opposing	対抗する
opt	選ぶ
option	選択肢
optional	任意の
or	または
oral	口頭の，口上の
orchestra	管弦楽団
order	注文
ordering	注文する
orders	注文
ordinary	普通の
organic	有機的な
oriented	〜志向の，〜本位の
original	独創的な
other	他の
others	他の物
ouch	痛い
ought	べきである
our	私達の
ours	私達のもの
ourselves	私たち自身
out of	〜外に
out there	向こうに
outta	[短] = out of
outcome	結果，成果
output	出力，生産高
outside	外側
outstanding	目立った，顕著な
oven	天火
over	〜の上に
overall	全体に渡る
overhaul	徹底的に点検する
overhead	頭上に，真上に
overlooked	見落とされた，見過ごされた，不遇の
overtime	時間が経つにつれ，そのうちに
overwrite	上書き
owe	借りがある
own	自身の
owners	所有者
oxygen	酸素
pace	歩調
pacific	太平洋
pack	包み
package	包装
packet	小包
page	ページ
paid	有料の
pail	手桶
pain	痛み
paint	塗る
pair	一対
palace	宮殿
panel	パネル
paper	紙，[俗] (paper moneyからきている) 金
paperback	紙表紙の興味本位の本，赤本：俗受けを狙った低俗な雑誌の類，いかがわしい内容の本
parallel	並列
parallelogram	平行四辺形
parcel	小包
parents	両親
park	公園
part	部分
particular	特別の
particularly	特別に
partner	組合員，連れ合い
party	会合
pass	通る
passage	通路
passengers	乗客
passion	激情，熱情，熱愛
passionate	熱烈な，熱情的な
password	合言葉
past	過去
path	小道，歩道，通路
paths	小道，歩道，通路
patrons	常連
pause	一時停止
pay	払う
payable	支払うべき
peace	平和
peaceful	平和な
peacefully	平和に
peacetime	平時
peak	最高点，絶頂，峰，山頂
peasant	農民
peculiar	変な
peer	同輩
peers	同輩
pending	〜するまで
people	人々
per	〜につき
percent	パーセント(%)
perennial	絶え間のない，長続きのする，多年生の
perfect	完全な
perform	成し遂げる，演奏する，演じる
performance	演技，演奏，実行，遂行，性能
performed	演奏する
performer	演技者，演奏者，実行者，遂行者，履行者
perhaps	たぶん
period	期間
permission	許可
permitted	許可する
personal	私的な
pests	害虫
phone	電話
phonograph	蓄音機
photo	写真
photograph	写真
phrase	句節
physical	自然の
piano	ピアノ
pick	つつく
pick-up	側部の低い、無蓋の車台のついた商品集配用の小型トラック
picture	絵
piece	一片，作品，楽曲
pipe	管，筒，パイプ
pipeline	送油管
pique	（好奇心を）刺激する
pivotal	中心の，重大な
pivotal character	重要人物
place	場所
placeholder	入力のヒント
placing	置く
plain	明白な
plan	計画
plane	平面
planet	惑星
plant	設備
plate	薄い板
play	演奏する
playback	再生
player	再生装置
please	どうぞ
pleasure	楽しみ
plenty	豊富
plus	プラス
pocket	ポケット
pocketbook	紙入れ，札入れ
poem	詩
poet	詩人
point	要点
point out	指し示す，指摘する
pointed	尖った．鋭い
pointed out	指し示した，指摘した
pointer	指示棒
pole	棒
policy	方針
politely	丁寧に
political bias	政治的偏向
poll	投票，選挙，投票する，得票する
poor	貧しい
popular	大衆音楽
port	港
portable	携帯の
portion	部分
position	地位
possession	所有
possible	可能な
post	掲載する，掲示する
postage	郵便料金
potential	可能性
pound	ポンド
power	力
powerful	強力な
powerhouse	発電所
powwow	北米インディアンの儀式
practical	実用的な
practice	練習
precautions	用心
preferably	より望ましい
prepare	準備する
presage	前兆，予感，予示する
presence	存在
present	贈物
press	押す
press conference	記者会見
pressing	押さえる
pretty	かわいい
prevalence	普及，広く行われていること，優勢
prevalent	広く行われている
prevent	妨げる
prevention	妨害
preview	試写会，試演，予告編，番組予告
previous	前の
previously	前もって，以前は
price	代価
prices	定価
priest	僧侶
priests	神官
primary	第一の
prince	王子
print	印刷する
printable	印刷できる
printed	印刷した
printer	印刷機
prize	賞，賞品，賞金
probably	たぶん
problem	問題，難問
problems	問題
procedure	手順
proclaim	宣言する，発表する
produce	生産する，産出する，製造する
producer	生産者，演出者，製作者
product	製品，産物
production	生産，製造，製作，生産高
productions	製品
products	製品
program	番組，番付，予定，計画，予定表
progress	進行
prolonging	延長している
promise	約束
prompted	刺激する
proper	適当な
properly	正しく
property	所有権
proprietary	所有の
proprietors	所有者
protective	保護する
protocols	取決め
proud	高慢な
prove	証明する
provide	供給する，提供する，用意する，扶養する
provided	もし〜ならば
provides	提供する
psych	心理的にまいらせる，不安にさせる，出し抜く，裏をかく，見抜く，見破る
psychedelic	万華鏡のような，催眠的な，蛍光色の
public	公共の
public figure	有名人
public relations	広報活動
public relations department	広報部
publication	公表(出版)
publicity	宣伝，広報
published	公表した
publisher	出版業者
publishers	出版業者
pueen	女王
puff	ぷっと吹く
pull	引く
pulp magazine	ざら紙を使った扇情的な安雑誌，粕取り雑誌，低俗な作品（読み物）
pulp magazine	低級な雑誌，粕取り雑誌：三号でつぶれるような粗悪な雑誌
pulsing	脈打つ
purchase	購入，購入する
purchased	購入した
purchases	買う
purchasing	購入
purpose	目的
push	押す
put	入れる
pyramid	ピラミッド，金字塔
qualification	資格
quality	品質
quantity	量
quarrel	口論
quarter	4分の1
quest	探求，追及
question	問い
questions	質問
quests	探求
quiet	まったく，完全に
quire	全く
quit	やめる
quotes	引用する
race	人種
rack	棚
radar	電波探知機
radio	ラジオ
rain	雨
raise	（高い位置に）上げる，（値段、給料などを）上げる，育てる
ramble	ぶらつく，散歩する
random	不規則な
range	範囲
ranks	階級
rare	まれな
rate	率
rates	割合
rather	どちらかと言えば
raunchy	野卑な，みだらな，好色な，だらしのない，いいかげんな，安っぽい，きたならしい
reach	届く
reacts	反応する
read	読む
readily	直ちに
reading	読み込む
ready	用意して
real	真実の
real estate	不動産
real estate agency	不動産業者
realise	[英] 実現する，実行する，悟る，実感する，理解する　[米] = realize
realize	[米] 実現する，実行する，悟る，実感する，理解する　[英] = realise
realized	実現された
really	真に
rear	近く
reason	理由
reboot	再起動
recall	再呼出し
receive	受け取る
received	受ける
recent	最近の
recently	近頃，最近
recession	不況
recognition	承認，認可
recognize	認知する，認める，承認する
recognized	認められた，承認された
recommend	推薦する
recommended	推薦した
record	記録
red	赤
redirection	再命令
reduces	減らす
reducing	減らしている
refer	調べる
reference	参考
referred	参照
reflect	反映する
reform	改革，刷新
refrain from	〜を控える
refund	払い戻し
refuse	断る
regard	注視する
region	地域，地方
regional	地域的な，地方的な
register	登録
registration	登録
regular	正規の，正選手，正出演者，定期出演者，常連出演者
regularly	規則正しく
reinforce	強化する
reinforcement	補強，強化
related	関係ある
relative	相対的な
relatively	比較的
release	発表する，公開する
release	封切りする，公開する，公表する，発表する，発売する　*名詞としても用いられる，売り出す，新発売
released	発表された
reliable	信頼できる
religion	宗教
remain	残る
remedy	救済する
remember	思い出す
remove	取り去る
removing	取り除く
remuneration	報酬
rename	改名する，命令し直す
renown	名声
renowned	名高い，有名な
repair	修理する
repeat	繰り返す
repeated	繰り返された，たびたびの
repeatedly	繰り返して
replace	元へ戻す
replaced	元へ戻す
replacement	入替え
replacing	元へ戻す
reply	答える
report	報告
reporter	記者
represent	描く
representative	代表者
representing	表す
request	要求
requests	再び求める
require	必要とする
require	要求する
required	要求した
requirement	要求
requirements	必要条件
requiring	必要とする
reset	置き直す，組み替える，（折れた骨を）繋ぎ合わせる
reside	住む，居住する
resident	常駐する
residents	在住
resides	住んでいる
resolution	解像度
resolving	分析する
resources	資源
respective	それぞれの
respectively	それぞれ
response	応答
responsible	責任を負う
rest	休む
restore	元に戻す
restriction	制限，限定，制限条件
result	結果
resume	再び続ける
resurrect	よみがえらせる
retail	小売り
retailed	小売りした
retained	保持
retreat	退く
return	帰る，戻る
reused	再び使う
revenge	あだ討ち
reverse	逆の，反対の，あべこべの，逆，反対，あべこべ，逆にする，反対にする，あべこべにする
review	評論
reviews	批評
revised	修正した
revision	修正
revivalist	復興者
rhyme	脚韻，押韻，*rimeとも略される
rhythm	律動
ribbon	リボン
rice	米
rich	金持ちの
rid	免れる
ride	乗る
right	右
ring	鳴らす
ripple	さざ波，さらさらという音
rise	上がる，上げる
river	川
road	道路
roast	〜を焼く
rob	〜から奪う
robber	強盗
robe	ローブ，式服，礼服
rock	岩
rogue	悪漢
roll	ころがる
roof	屋根
room	部屋
root	根
rope	ロープ
rotate	交代する，循環する
rotation	交代，回転，循環
rough sleeper	路上生活者，野宿者
roulette	ルーレット
round	丸い
round-trip ticket	往復券
rousing	鼓舞する
routines	手順
royalties	印税
rub	〜をこする
rubber	ゴム，ゴム製の
rude	無作法な
rug	敷物
ruin	破滅
ruins	廃虚
rule	規則，規定，法則
rumor	[米] 風説，噂，評判　[英] = rumour
rumour	[英] 風説，噂，評判　[米] = rumor
run	走る，流れる
run the risk	危険を冒す
running	走る，連続した
rush	突進する
rvelte	すらりとした
sack	袋
sad	悲しい
safe	安全な
safety	安全
same	同じ
sample	見本
sarve	仕える
save	守る，保つ，蓄える，貯蓄する
saving	救う，救済する，節約する，救助，救済
savings account	普通預金
say	言う
scatter	まく，散らす
scenario	筋書き，台本
scene	場面
scenery	風景
school	学校
school	流派
scientific	科学の
score	得点
scrape	掻き集める，寄せ集める
scraping	画面上に表示される情報をプログラムを使って評価し必要な情報を収集する事
screen	障子，映写幕，銀幕
scroll	巻物
sea	海
seacoast	海岸
seaman	船乗り
seamlessly	継ぎ目ない
seaport	港町
search	捜索
searching	捜索する
seaside	海辺
season	季節
seat	席
second	秒
secondary	第二の
secondhand	中古の
secret	秘密，秘訣
section	区画
see	見る，会う
seeing	〜をみると，〜なので
seen	〜のように見える
segment	部分，文節，区分
select	選ぶ
selected	選択した
selecting	選ぶ
selection	選択
self-defence	自衛手段
sell	売る，捨てる，裏切る
send	送る
sense	感覚
sensibility	感受性，敏感，多感
sensibly	目立つ
sent	送られた
sentence	文
Sep.	9月
September	9月
sequel	続編
sequence	連続
series	連続，続き物
service	奉公，奉仕
session man	特定のバンドに所属しないで、さまざまなアーティストと共演するミュージシャン
session musician	session man と同じ
set	据える，一組，一式
set up	起こす，立てる，組み立てる
settle	落ち着く，安住する
several	数個
shade	日陰
shadow	影
shadowing	影にする
shady	日陰の
shake	〜をゆり動かす
shakes	振る
shall	〜だろう
shame	恥
shape	形
share	分ける
shell	殻，鞘
shift	変わる，移る，転じる，変更，交代
shine	光る
ship	船
shipping	送料
shop	店
shops	店
short	短い
shortcut	近道
shots	写真
should	〜すべきである
should've	[短] = should have
shoulder	肩
shout	叫ぶ
show	見せる
showing	見せる
shown	見せる
shut	締める
sick	病気の
sickness	病気
side	側面
side by side	横に並んで
side effect	副作用
sidewalk	歩道
sign	署名，兆候，看板，掲示，標識，お告げ，記号，符号，署名する，ため息をつく
signal	信号，合図，信号機
signature	署名
silence	沈黙
silver	銀
similar	類似の
simple	簡単な
simply	簡単に
simulat	装う，真似る，似せる
simulation	真似，見せ掛け，偽り
simultaneously	同時に
since	それ以来
single	単独の
sit	座る
sitcom	[短] situation comedy 連続ホームコメディ
site	位置，場所，土地
size	寸法，大きさ
sketch	写生画，見取り図
sketchbook	写生帳
skills	技量
skip	軽く飛ぶ，跳ねる，飛ばす
sky	空
slab	厚板
slap	平手打ち
slave	奴隷
slavery	奴隷制
sled	荷そり
sleek	流線型の，格好いい
sleep	眠る
sleeping	眠っている
sleepy	眠い
sleeve	袖
slept	眠った
slightly	少し，かすかに
slings	投石器
slowly	遅く
small	小さい
smaller	より小さい
smile	笑う
smoke	煙
smoothly	滑かに
snake	蛇
sneeze	くしゃみ
snow	雪
snow-white	雪のように白い
snowballing	雪合戦
snowman	雪だるま
snowy	雪が降る
so long as	〜である限りは
so-and-so	だれそれ，なにがし
so-called	いわゆる，世間で言う
society	社会
soft	柔らかい
soldier	兵士
solicit	懇願する，（注意を）促す
solicitation	懇願
solidify	固める，強固にする	
solist	独奏者，独唱者
solo	独奏
solos	独奏
solve	解決する
solved	解決
solves	解決する
solving	解決
some	多少の
somebody	だれか
something	何か
sometimes	時々
somewhat	多少
somewhere	どこかに
songster	歌手
songstress	女性の人気歌手
songwriter	ポピュラー音楽の作詞、作曲または両方をする人
soon	じきに
sorry	すまない
sort	分類する
sorta	[短] = sort of
soul	魂
sound	響き，音響
source	源泉，出所，原因
south	南
space	空間
spaceship	宇宙船
span	渡る，及ぶ
speak	話す
speaker	話者
special	特別の
specific	特別の
specification	詳説
specifies	指定する
specify	指定する
specifying	明示する
spectacular	壮観な，目を見張る
spectator	見物人
speech	演説，講演，挨拶，談話
speed	速度
speeding	超速
spell	綴る，まじないの文句，呪文
spend	費やす
spider fly	蜘蛛に似せて作った毛鉤の一種
spokesman	広報担当者
spot	斑点
spread	広げる
spring	飛ぶ
square	区画
square	四角
stadium	競技場
stage	舞台
staicase	階段
stain	よごれ
stair	段
stairway	階段
stand	立つ
stand for	〜の略である
standard	標準
standards	標準
star	人気者，花形，立役者
start	出発する
state	状態
stated	規定の，定期の
station	駅
statistics	統計
status	状態
stay	留まる
stem	茎，葉柄
step	階段
step down	退陣する，辞任する
stick	刺す
still	まだ
stimulate	刺激する
stock	在庫
stone	石
stop	止める
stops	停止
store	蓄える
stores	必要品
storm	嵐
story	物語，（建物の）階：10-story 10階
straight	まっすぐ
strange	未知の
strategies	方式(作戦)
strategy	戦略
stream	流れ
street	通り
strength	強さ	強さ
strike	打つ
strives	努力する
strong	強い
structure	構造
structures	構造
studio apartment	bed-sitting-room と同義，	
studios	映画撮影所，映画会社，（ダンスなどの）練習所
study	勉強
stuff	資料，物事，事項
style	格好
stylish	粋な
stylist	名文家
subject	科目
subject	自由に〜できる
submit	提出する
subscription	予約
subsidiary	子会社
substantial	かなりの
substitute	置き換える
suburb	郊外，近郊
subway	地下鉄
success	成功
successfully	首尾よく
such	このような
sudden	急な
suddenly	急に
suffer	苦しむ
suffice	足りる
suggest	思い付かせる
suggestions	提案
suit	合う
sum	合計
summary	略式の
superb	素晴らしい，見事な，壮麗な，豪華な
superior	優れた
supervise	監督する
supervisor	監督者
supplant	〜に取って代わる，奪い取る
supplemental	補助の
supplied	供給された
supply	供給する
support	支える，助ける，裏付ける，与える，支持する，利用可能にする，提供する，伴奏する，助演する
supporting	支持する
suppose	想像する
supposed	想像された
sure	確かな
surface mail	船便
surprise	驚く
survive	生き残る
suspend	保留する
sutudio	放送室，録音室，仕事場，画室，彫刻室，（美術や写真の）制作会社
swap	取り替える
sweep	〜を掃除する
sweet	甘い
switch	開閉器
symbol	象徴
system	組織，制度，体系
table	食卓，表
tack	びょう
take	取る
take a chance	賭けてみる
take over	引き継ぐ
takes	取る
tale	うわさ
talented	有能な
tales	うわさ
talk	話す
tall	高い
tanks	戦車
tape	平ひも，テープ
target	的
task	仕事
tasks	仕事
tavern	宿屋
teach	教える
teach myself	独学で
teacher	先生
team	組
tear	裂く
technical	専門の，専門的な，技術の
technically	専門的に
technique	技術，技巧，手法
technology	科学的技術
telephone	電話
tell	告げる
temple	神殿
ten	10
terminate	終わる
terms	条件
territory	領土
test	試験
Tex.	Texasの略
Texan	テキサス州人
Th.	Thursdayの略；木曜日
than	〜よりも
thank	感謝する
thankful	感謝している
thanks	感謝する
the Library of Congress	議会図書館（ワシントンD.C.にある米国議会の附属図書館）
the overall cost	全費用
the overall length	全長
the whole time	ずっと
theater	劇場
their	それらの
them	それらを
themselves	彼ら自身，それら自体
then	〜よりも
there	そこに
thereafter	その後
therefore	その結果，それ故，それで
therein	その中に
these	これら
they	それらは
thick	厚い
thicken	厚くなる
thickly	厚く，太く，濃く
thickness	厚さ，太さ，濃さ
thief	泥棒
thin	薄い
thing	物事
think	考える
those	それらの
though	〜だけれども
thought	考え
thousands	たくさんの
three	3
three dots	前略や中略、後略などを示す符号「...」を言う。= leader dots
through	〜を通して
throw	投げる
thunder	雷
ticket	券
tie	結ぶ
tightly	しっかりと
till	〜まで
time	時間
times	時間
timing	適時
tired	疲れた
to	〜に，〜へ，〜まで，〜のために，〜する，〜すること
to scale	実物大で
to the brief	簡単に言えば
today	今日
together	一緒に
tomb	墓，霊廟，納骨堂
too	〜もまた，あまりに
top	頂上，天辺
torch singer	失恋の曲を歌う歌手
total	全体の，統計の
touch	触れる，感動させる
touching	悲しい，哀れな，人の心を動かす
tour	旅行，観光旅行，漫遊
toward	〜の方へ
town	町
trace	跡，足跡，形跡
tracer	追跡者，捜索者，曳航弾，発煙弾
track	足跡，形跡，走路
trade	商売，交易，貿易
trademark	商標
tradition	慣例，因習，伝統
traditional	慣習的，伝統的
tragic	悲劇の
train	行列
trained	訓練された
tramp	夢をみながらの放浪
transfer	乗り換え
transplant	移住する
transport	移送，輸送する	
transportation	運搬
travel	旅行
traveler	[米] 旅行者，旅行家，旅人　[英] = traveller
traveller	[英] 旅行者，旅行家，旅人　[米] = traveller
treasure	宝物，財宝
tree	木
trend	傾向，趨勢，動向
trial and error	試行錯誤
trilogy	三部作
trip	旅行
trival	部族の
trouble	困難
true	真実の
true colors	本当の姿，本来の姿
trust	信用する
truth	真実
try	試みる，努める，努力する
trying	苦しい，辛い
tube	管
tuesday	火曜日
tumble	倒れる
tune	〜の調子を合わせる
turn	回す，回転させる，方向を変える
twelfth	12番目
twelve	12
twentieth	20番目の
twenty	20
twice	2度
twilight	薄明り
twist	意外な転回，急変，（事実を）捻じ曲げる，（意味を）曲解する
two	2
TX	Texasの略；郵便用語上の略
type	型，種類，活字
typewriter	タイプライター
typist	タイピスト
tyrant	圧政者
ugly	醜い
uh	[米] はい　[英] = er
ultimate	究極の
ultra	過激な
umbrella	雨傘
umpire	審判員
uncivil	無作法な
undeniable	否定出来ない，極めて優秀な
under	〜の下に，の下へ，〜以下
underground	地下や大矢家でない所で作られ発表されている反体制的・前衛的な芸術や出版物
understand	理解する
understanding	理解する
understands	理解する
unique	独特の，独自の，唯一無二の，珍しい，風変わりな
uniquely	比類なく，独特に
uniqueness	独特，風変わり
unit	単位，構成単位
universal	汎用
universe	全世界
unlearn	忘れる
unless	もし〜でなければ
unlike	似ていない
unlock	錠を開ける
until	〜まで
up	上へ，上に，上で
upcoming	間もなく起こる，近日公開される
updated	更新した
updates	更新
upgrade	等級を上げる
upload	（小型コンピュータから大型コンピュータへデータやファイル）を転送する
upon	その上に
Urban transportation	都市交通
us	私達
usage	使用法
use	使う
use	使う
used	使っている
user	使用者
using	使っている
usual	いつもの
usually	通常
utility	有用性，有益
utility company	公益事業会社
vacation	休暇
vain	無駄な
valid	正当な，有効な
validate	有効にする，批准する
valuable	貴重な
value	価値
vane	風見
various	さまざまな
vary	変更する
vast	巨大な
vendors	売る人
venue	開催地，裁判地，現場，現地，会場
venues	開催地，裁判地，現場，現地，会場
verified	実証した
verify	確かめる
versatile	多様な
version	説明，意見，見解，異説，〜版，翻案，脚色，編曲，翻訳，訳書，訳文
very	大変
veteran	実践経験を積んだ
via	〜経由で
vibe	= vibration; 相互反応する，気持ちが合う
vibes	雰囲気，直感，第六感，感触，= vibraharp ヴィヴラハープ，マリンバ
vibration	振動，動揺，霊気，= vibes 雰囲気，直感，第六感
vibrato	振動音
vicinity	近隣
victory	勝利
video	ビデオ
view	見る
village	村
virtual	真の
virtually	事実上
visit	訪問する
voice	声
volume	(本の)巻
vote	投票
voyage	航海
wait	待つ
wake	目覚める
walk	歩く
wall	壁
wanna	[短] = want to
wane	衰微，減退，欠ける，減少する，衰える
want	欲する
war	戦争
ware	商品
warehouse	倉庫
warfare	戦争
warm	暖かい
warned	警告
warning	注意
warranty	保証
waste	浪費，無駄
watch	注視する，時計
we	我々
weak	弱い
weakness	弱み，短所
weapon	武器
wear	着る
weather	天気
weather forecast	天気予報
weekday	週末
weight	重量
welcome	歓迎する
well	上手に
well-groomed	身なりの良い
west	西
what	何
when	いつ
where	どこに
whether	〜かどうか，〜であろうとなかろうと
which	どれ
while	〜の間
white	白
who	誰；WHO (World Health Organization) 世界保健機構
whole	欠ける所のない，完全な
whole picture	全体像，大局
whom	誰を，誰に
whose	誰の
why	なぜ
wide	広い
wild	野生の
wilderness	荒野，荒地
will	〜でしょう
win	勝つ
wind	風
window	窓
wing	翼
winner	受賞者
winning	勝った，優勝した
wire	盗聴器
wise	賢明な，分別がある
wish	〜したいと思う，願い，願望，希望
with	〜と共に，〜と一緒に
withdraw	引き出す
within	〜の内に
without	〜なしに
wizardry	素晴らしい技能
wolf	狼
wolves	狼達
wonder	驚異，驚嘆
wonderful	驚くべき，素晴らしい
wood	森
word	語，単語
work	働く
workboat	作業船，工船
workshop	作業場，研究会，講演会
worktable	作業台
world	世界
worldwide	世界的な，世界的に，全世界的に
worth	価値
would've	[短] = would have
write	書く
writer	筆者，作家，著作家
written	書かれた
wrong	悪い，正しくない，誤った，不正，悪，曲がったこと
ya	[俗] = you
yard	庭
year	年，歳
yellow	黄色
yet	まだ
you	君は，誰でも：わざわざ訳す必要がない時もある
you're	you are の略
you've	you heve の略
your	君の
yours	君のもの
youth	若さ，青春，青年，若者
